book=media||blog,radio,television,internet,broadcasting,picture
movie=media||
media=|movie,book,radio,television,internet,broadcasting,picture|
internet=media|blog|broadcasting,picture,movie,book,radio,television
math=subject||
person=||
term=||
computer-language=language,computer|python,javascript,R,java,julia,swift|
python=computer-language|numpy,scikit-learn,pandas,scikit|javascript
R=computer-language||python
scikit-learn=python,machine-learning||numpy,pandas,scikit
numpy=python||scikit-learn,pandas,scikit
machine-learning=ai||data mining,statistics,scikit-learn
amazon=company|aws,kindle|google,book
aws=amazon||gae
apple=company|swift,iphone,|google,amazon
google=company|gae|amazon
bigdata=term|machine learning,data-mining|google,amazon
MathJax=javascript,math||latex
git=software,revision-control||svn
statistics=math||machine-learning,data mining
d3=javascript||angularjs,jquery
javascript=computer-language|jquery|python,R
statistics=math|time-series,bootstrap|r,pandas
time-series=statistics||
bootstrap=statistics||
biography=person||
john-nash=person,math,biography|game theory|beautiful-mind
sapience=history||
alan turing=person,math,biography|turing-machine|enigma,computer
document=book,movie||biography,history,science,math
swift=computer-language||apple,iphone
computer=machine||science,math